0, 0, 0, 0, 0, 0, 0, 0, 0, 0, 0, 0, 0, 0, 0, 0, 0, 0, 0, 3, 3, 1, 0, 4, 4, 2, 0, 0, 0, 0
2, 2, 7, 6, 7, 2, 0, 0, 0, 0, 0, 0, 0, 0, 4, 7, 3, 6, 4, 4, 0, 7, 6, 1, 0, 7, 2, 0, 0, 0
2, 0, 0, 0, 0, 2, 0, 0, 0, 0, 0, 0, 0, 4, 6, 0, 0, 0, 7, 0, 0, 0, 0, 0, 0, 0, 2, 0, 0, 0
2, 0, 0, 0, 0, 2, 2, 1, 1, 6, 3, 7, 1, 4, 0, 0, 0, 0, 1, 4, 4, 7, 0, 0, 0, 4, 1, 0, 0, 0
7, 0, 0, 0, 0, 0, 0, 0, 3, 0, 0, 0, 0, 1, 0, 0, 0, 0, 0, 0, 0, 3, 0, 0, 0, 4, 0, 0, 0, 0
7, 0, 0, 0, 0, 0, 0, 0, 3, 0, 0, 0, 0, 1, 6, 3, 0, 0, 0, 0, 0, 4, 0, 0, 0, 7, 4, 4, 0, 0
2, 2, 2, 0, 0, 0, 0, 0, 7, 0, 0, 0, 0, 0, 0, 3, 1, 4, 7, 2, 2, 4, 6, 4, 4, 0, 0, 6, 0, 0
0, 0, 2, 0, 0, 0, 0, 0, 1, 0, 0, 0, 0, 0, 0, 0, 0, 0, 0, 0, 0, 3, 0, 0, 1, 1, 3, 4, 0, 0
0, 0, 1, 0, 0, 0, 0, 0, 7, 0, 0, 0, 0, 0, 0, 0, 0, 0, 7, 1, 3, 7, 0, 0, 0, 0, 0, 0, 0, 0
0, 0, 1, 0, 0, 0, 0, 0, 6, 1, 7, 1, 4, 3, 0, 0, 0, 2, 1, 0, 0, 7, 6, 4, 3, 1, 0, 0, 0, 0
7, 3, 3, 3, 0, 0, 0, 0, 0, 0, 0, 0, 0, 4, 4, 6, 1, 1, 0, 0, 0, 0, 0, 0, 0, 1, 0, 0, 0, 0
7, 0, 0, 1, 0, 0, 0, 0, 0, 0, 0, 0, 0, 4, 0, 0, 0, 0, 0, 0, 0, 0, 0, 0, 0, 5, 5, 0, 0, 0
3, 0, 0, 1, 0, 0, 0, 0, 0, 0, 0, 0, 0, 3, 0, 0, 0, 0, 0, 0, 0, 0, 0, 0, 0, 0, 5, 0, 0, 0
3, 0, 0, 6, 3, 3, 1, 3, 1, 0, 0, 0, 0, 3, 0, 0, 0, 0, 0, 0, 0, 0, 0, 0, 0, 0, 6, 0, 0, 0
1, 3, 0, 0, 0, 0, 0, 0, 7, 6, 3, 1, 1, 7, 1, 3, 1, 0, 0, 0, 0, 0, 0, 0, 0, 0, 1, 5, 5, 0
0, 4, 4, 0, 0, 0, 0, 0, 0, 0, 0, 0, 0, 0, 0, 0, 6, 1, 7, 0, 0, 0, 0, 0, 0, 5, 7, 0, 7, 0
0, 0, 4, 6, 0, 0, 0, 0, 0, 0, 1, 1, 1, 6, 0, 0, 0, 0, 1, 1, 1, 7, 6, 1, 1, 5, 0, 0, 5, 5
0, 0, 0, 6, 4, 1, 0, 0, 0, 0, 3, 0, 0, 3, 3, 1, 7, 3, 3, 0, 0, 0, 0, 7, 0, 0, 0, 0, 0, 6
0, 0, 0, 0, 0, 3, 2, 2, 2, 3, 3, 0, 0, 0, 0, 0, 0, 0, 0, 0, 5, 5, 5, 7, 0, 0, 0, 0, 5, 6
0, 0, 0, 0, 0, 0, 0, 0, 0, 0, 0, 0, 0, 0, 0, 0, 0, 0, 0, 0, 6, 0, 0, 0, 0, 2, 2, 2, 1, 0
0, 0, 0, 0, 0, 0, 0, 0, 0, 0, 0, 0, 0, 0, 0, 0, 0, 0, 0, 0, 7, 6, 5, 5, 1, 5, 0, 0, 0, 0